....#############..................................
....#...........#..................................
....#...........#..................................
....#...........#..................................
....#...........#..................................
....#...........#..................................
#####...........#...............#############......
#...............#...............#...........#......
#...............#...............#...........#......
#...............#...............#...........#......
#...............#...............#...........#......
#...............#...............#...........#......
#.....###########...............#...........#......
#...............................#...........#......
#...............................#...........#......
#...............................#...........#......
#########.......................#.###########......
........#.......................#.#................
........#.......................#######............
........#.........................#...#............
........#.........#######.......###########........
........#.........#.....#.......#.#...#...#........
........#.......###########.....#.#...#...#........
........#.......#.#.....#.#.....#.#...#...#........
........#.......#.#.....###########...#...#........
........#.......#.#.......#.....#.....#...#........
........###########.......#######.....#...#........
................#.....................#...#........
................#.....................#######......
................#.........................#.#......
......^##########.........................#########
............................................#.....#
............................................#.....#
............................................#.....#
..................................###########.....#
..................................#...............#
..................................#...............#
..................................#...............#
..................................#...............#
..................................#...............#
..................................#...........#####
..................................#...........#....
..................................#...........#....
..................................#...........#....
..................................#...........#....
..................................#...........#....
..................................#############....

